1111111
1PCEC01
1H010V1
1111111