11111111111111111111
100C000000000C0000C1
10010001H00001V11H01
1P111V111C1111111011
110011C0111110001001
1HV000100000H0001101
10010100111000100V01
1101C1000H1000110011
1001110011100H100001
1010E1001C0000110001
10000100111H00100011
1100000V00000000V0C1
11111111111111111111