11111111111111111111
10001000000000000001
1P00C000111100C10001
11111111100111111101
101C000010000C000101
10101010001111000001
10101010000001000001
10001110001111000001
10000010001000000001
10000010001111000001
11111111111111111111