11111111111111111111
100010000000000C0001
1P000000111100010001
11111111100111111101
1E100000100000000101
10101010001111000000
10101010000001000001
10001110001111000001
10000010001000000001
10000010001111000001
11111111111111101111